[
  {
    "type": "palette",
    "id": "fcl_aug_clinic",
    "terrain": {
      " ": "t_region_groundcover_urban",
      "!": "t_door_locked_interior",
      "-": "t_wall_metal",
      "|": "t_concrete_wall",
      "+": "t_door_c",
      "0": "t_vat",
      "9": "t_window_domestic",
      ":": "t_door_glass_c",
      ";": "t_door_locked",
      "=": "t_wall_glass",
      "(": "t_reinforced_glass",
      "X": "t_door_metal_locked",
      "ó": "t_metal_ventilation_shutter",
      "Y": "t_thconc_floor_olight",
      "R": "t_railing",
      "w": "t_window",
      ">": "t_stairs_down",
      "<": "t_stairs_up",
      "~": "t_sidewalk"
    },
    "furniture": {
      "$": "f_safe_l",
      "A": "f_IV_pole",
      "&": "f_toilet",
      "%": "f_console_broken",
      "5": "f_console",
      "B": "f_bed",
      "S": "f_sink",
      "b": "f_bench",
      "c": "f_counter",
      "d": "f_desk",
      "h": "f_chair",
      "H": "f_utility_shelf",
      "l": "f_locker",
      "k": "f_bookcase",
      "r": "f_trashcan",
      "s": "f_sink",
      "t": "f_metal_table",
      "f": "f_filing_cabinet",
      "^": "f_indoor_plant"
    },
    "items": { "&": { "item": "SUS_toilet", "chance": 50 } },
    "toilets": { "&": {  } }
  },
  {
    "type": "mapgen",
    "om_terrain": [ "fcl_augmentation_clinic_n1" ],
    "weight": 200,
    "object": {
      "fill_ter": "t_strconc_floor",
      "rows": [
        "                   ∑,   ",
        "                   ,,   ",
        " -ó-----------    |,,|  ",
        " -.--0.H%%H.0-     ,,   ",
        " -.--0......0-     ,,   ",
        " -.--0......0-     ,,   ",
        " -.--0......0-     ,,   ",
        " -.----...------  |,,|  ",
        " -.--0......0-.-V,,,,,, ",
        " -.--0......0ó.-V,,,Y,, ",
        " ó.--0......0-.- |<,,|  ",
        " ------(:(----.- |||||  ",
        " -lb..:.Y.:..-.-        ",
        " -lb.l|...(.0-.-        ",
        " -llll|^.^(.A-.-        ",
        " ----|||:||||-.-------- ",
        "  -.!........-.óö....óó ",
        "  -<-((('((((----.S-.-- ",
        "  ---c.........-EEE-.óó ",
        "    -c..tt..dh.-------- ",
        "    -c..B...d.n-        ",
        "    ------------        ",
        "                        ",
        "                        "
      ],
      "palettes": [ "fcl_aug_clinic" ],
      "terrain": { "'": "t_door_glass_o", ".": "t_strconc_floor", ",": "t_sidewalk", "∑": "t_sidewalk" },
      "furniture": {
        "?": "f_autodoc",
        "/": "f_autodoc_couch",
        "T": "f_table",
        "n": "f_trashcan",
        "E": "f_machinery_electronic",
        "B": "f_xray"
      },
      "items": {
        "c": { "item": "dissection", "chance": 80, "repeat": [ 1, 3 ] },
        "d": { "item": "office", "chance": 60 },
        "l": [
          { "item": "dresser", "chance": 60, "repeat": [ 4, 9 ] },
          { "item": "harddrugs", "chance": 30, "repeat": [ 1, 3 ] },
          { "item": "drugs_analgesic", "chance": 20, "repeat": [ 1, 3 ] },
          { "item": "gear_medical", "chance": 20 }
        ],
        "H": [
          { "item": "harddrugs", "chance": 60 },
          { "item": "gear_medical", "chance": 60, "repeat": [ 1, 3 ] },
          { "item": "drugs_analgesic", "chance": 60, "repeat": [ 1, 3 ] },
          { "item": "drugs_rare", "chance": 60 },
          { "item": "surgery", "chance": 60 }
        ],
        "?": { "item": "autodoc_supplies", "chance": 100 }
      },
      "monster": {
        "ö": { "monster": "mon_skitterbot" },
        "∑": { "monster": "mon_zombie_static" }
      },
      "vendingmachines": { "V": { "item_group": "fcl_vending_medicine", "reinforced": true } }
    }
  },
  {
    "type": "mapgen",
    "om_terrain": [ "fcl_augmentation_clinic_n1" ],
    "weight": 50,
    "object": {
      "fill_ter": "t_strconc_floor",
      "rows": [
        "                   ,,   ",
        "                   ,,   ",
        " -ó-----------    |,,|  ",
        " -.--0.H%%H.0-     ,,   ",
        " -.--0......0-     ,,   ",
        " -.--0......0-     ,,   ",
        " -.--0......0-     ,,   ",
        " -.----...------  |,,|  ",
        " -.--0......0-.-V,,,,,, ",
        " -.--0......0ó.-V,,,Y,, ",
        " ó.--0......0-.- |<,,|  ",
        " ------(:(----.- |||||  ",
        " -lb..:.Y.:..-.-        ",
        " -lb.l|...(.0-.-        ",
        " -llll|^.^(.A-.-        ",
        " ----|||:||||-.-------- ",
        "  -.!........-.óö....óó ",
        "  -<-((('((((----.S-.-- ",
        "  ---c...∑.....-EEE-.óó ",
        "    -c..]...dh.-------- ",
        "    -c..B...d.n-        ",
        "    ------------        ",
        "                        ",
        "                        "
      ],
      "palettes": [ "fcl_aug_clinic" ],
      "terrain": { "'": "t_door_glass_o", ".": "t_strconc_floor", ",": "t_sidewalk" },
      "furniture": {
        "?": "f_autodoc",
        "/": "f_autodoc_couch",
        "T": "f_table",
        "n": "f_trashcan",
        "E": "f_machinery_electronic",
        "B": "f_xray"
      },
      "items": {
        "c": { "item": "dissection", "chance": 80, "repeat": [ 1, 3 ] },
        "d": { "item": "office", "chance": 60 },
        "l": [
          { "item": "dresser", "chance": 60, "repeat": [ 4, 9 ] },
          { "item": "harddrugs", "chance": 30, "repeat": [ 1, 3 ] },
          { "item": "drugs_analgesic", "chance": 20, "repeat": [ 1, 3 ] },
          { "item": "gear_medical", "chance": 20 }
        ],
        "H": [
          { "item": "harddrugs", "chance": 60 },
          { "item": "gear_medical", "chance": 60, "repeat": [ 1, 3 ] },
          { "item": "drugs_analgesic", "chance": 60, "repeat": [ 1, 3 ] },
          { "item": "drugs_rare", "chance": 60 },
          { "item": "surgery", "chance": 60 }
        ],
        "?": { "item": "autodoc_supplies", "chance": 100 }
      },
      "monster": {
        "ö": { "monster": "mon_skitterbot" },
        "∑": [ { "monster": "mon_nursebot" } ]
      },
      "vehicles": {
        "]": { "vehicle": "hospital_bed", "rotation": 180 },
        "[": { "vehicle": "hospital_bed", "rotation": 90 }
      },
      "vendingmachines": { "V": { "item_group": "fcl_vending_medicine", "reinforced": true } }
    }
  },
  {
    "type": "mapgen",
    "om_terrain": [ "fcl_augmentation_clinic_n2" ],
    "object": {
      "fill_ter": "t_strconc_floor",
      "rows": [
        "                        ",
        "                        ",
        " |||||||((((((    |..|  ",
        " |&s|^RÁ.ooot(          ",
        " |r.|^......o(          ",
        " ||+|^....t.o(          ",
        " |^.........o(          ",
        " ||+|^.....|||||RRRRRRR ",
        " |&.|^hd......Y:......R ",
        " |rs|^.d......Y:......R ",
        " |||||||:||||||||R>..RR ",
        " |Sccl|...|lccS| RRRRR  ",
        " |....:.Y.:....|        ",
        " |./?.=...=.?/.|        ",
        " |....=^.^=....|        ",
        " |||||||:|||||||---ó--- ",
        "  |<!...........X....H- ",
        "  |>||:|||:||||5-....H- ",
        "  |||c..|Y.Y.c||-$ll$H- ",
        "    |S..|.?/..c|------- ",
        "    |S..|..A..c|        ",
        "    ||||||||||||        ",
        "                        ",
        "                        "
      ],
      "palettes": [ "fcl_aug_clinic" ],
      "terrain": { " ": "t_open_air" },
      "furniture": { "?": "f_autodoc", "/": "f_autodoc_couch", "o": "f_sofa", "T": "f_metal_table", "Á": "f_armchair", "n": "f_trashcan" },
      "computers": {
        "5": {
          "name": "Secure Bionic Storage Access",
          "security": 2,
          "options": [ { "name": "Unlock Door", "action": "unlock" } ],
          "failures": [ { "action": "shutdown" }, { "action": "alarm" } ]
        }
      },
      "items": {
        "B": { "item": "hospital_bed", "chance": 60 },
        "R": { "item": "SUS_trash_floor", "chance": 50 },
        "o": { "item": "waitingroom", "chance": 60 },
        "e": { "item": "SUS_fridge", "chance": 80 },
        "C": { "item": "dresser", "chance": 75 },
        "$": [
          { "item": "bionics", "chance": 70, "repeat": [ 1, 2 ] },
          { "item": "fcl_bionics_power", "repeat": [ 1, 2 ] }
        ],
        "f": { "item": "SUS_office_filing_cabinet", "chance": 90 },
        "d": { "item": "SUS_office_desk", "chance": 60 },
        "l": [
          { "item": "harddrugs", "chance": 30, "repeat": [ 1, 3 ] },
          { "item": "drugs_analgesic", "chance": 20, "repeat": [ 1, 3 ] },
          { "item": "gear_medical", "chance": 20 }
        ],
        "c": [
          { "item": "harddrugs", "chance": 30, "repeat": [ 1, 3 ] },
          { "item": "drugs_analgesic", "chance": 20, "repeat": [ 1, 3 ] },
          { "item": "surgery", "chance": 40 }
        ],
        "H": [
          { "item": "harddrugs", "chance": 60 },
          { "item": "gear_medical", "chance": 60, "repeat": [ 1, 3 ] },
          { "item": "fcl_bionics_power", "repeat": [ 1, 2 ], "chance": 60 },
          { "item": "drugs_analgesic", "chance": 60, "repeat": [ 1, 3 ] },
          { "item": "drugs_rare", "chance": 60 },
          { "item": "surgery", "chance": 60 }
        ],
        "?": { "item": "autodoc_supplies", "chance": 100 }
      }
    }
  },
  {
    "type": "mapgen",
    "om_terrain": "fcl_augmentation_clinic_n3",
    "object": {
      "fill_ter": "t_floor",
      "rows": [
        "                        ",
        "                        ",
        " ---------------------- ",
        " -....................- ",
        " -....................- ",
        " -........o...........- ",
        " -....................- ",
        " -....................- ",
        " -....................- ",
        " -....................- ",
        " -......#w##w##w##....- ",
        " -.######bt#bt#bt#....- ",
        " -.#f__f#__#__#__#....- ",
        " -.#f__f#+##+##+##....- ",
        " -.#f__f#________#....- ",
        " -###+###_########A...- ",
        "  #>____+_+_____L#A...- ",
        "  ####w##_#y_/?_t#....- ",
        "  ---..4##########....- ",
        "    -.....&=...5------- ",
        "    -..........-        ",
        "    ------------        ",
        "                        ",
        "                        "
      ],
      "terrain": {
        ".": "t_flat_roof",
        "=": "t_flat_roof",
        "&": "t_flat_roof",
        "A": "t_flat_roof",
        " ": "t_open_air",
        "o": "t_glass_roof",
        ">": "t_stairs_down",
        "#": "t_wall_b",
        "_": "t_floor",
        "w": "t_wall_glass",
        "+": "t_door_glass_frosted_lab_c",
        "-": "t_gutter",
        "4": "t_gutter_downspout",
        "5": "t_gutter_drop"
      },
      "furniture": {
        "&": "f_roof_turbine_vent",
        "=": "f_vent_pipe",
        "b": "f_bed",
        "t": "f_metal_table",
        "c": "f_armchair",
        "f": "f_filing_cabinet",
        "?": "f_autodoc",
        "L": "f_locker",
        "/": "f_autodoc_couch",
        "y": [ "f_indoor_plant_y", "f_indoor_plant" ],
        "A": "f_air_conditioner"
      },
      "items": {
        "b": { "item": "hospital_bed", "chance": 60 },
        "f": { "item": "SUS_office_filing_cabinet", "chance": 70 },
        "L": [
          { "item": "harddrugs", "chance": 60, "repeat": [ 1, 3 ] },
          { "item": "gear_medical", "chance": 60, "repeat": [ 1, 3 ] },
          { "item": "drugs_analgesic", "chance": 60, "repeat": [ 1, 3 ] },
          { "item": "drugs_rare", "chance": 60 },
          { "item": "surgery", "chance": 60 }
        ],
        "?": { "item": "autodoc_supplies", "chance": 100 }
      }
    }
  },
  {
    "type": "mapgen",
    "om_terrain": "fcl_augmentation_clinic_n4",
    "object": {
      "fill_ter": "t_flat_roof",
      "rows": [
        "                        ",
        "                        ",
        "                        ",
        "                        ",
        "                        ",
        "                        ",
        "                        ",
        "                        ",
        "                        ",
        "                        ",
        "        ----------      ",
        "   ------........-      ",
        "   -..........:..-      ",
        "   -.X...........-      ",
        "   -.............-      ",
        "  --.............-      ",
        "  -........oooo..-      ",
        "  ------5........-      ",
        "        ----------      ",
        "                        ",
        "                        ",
        "                        ",
        "                        ",
        "                        "
      ],
      "palettes": [ "roof_palette" ]
    }
  }
]
