[
  {
    "type": "mapgen",
    "om_terrain": [ "bunker_basement_1" ],
    "weight": 150,
    "object": {
      "fill_ter": "t_floor",
      "rows": [
        "........................",
        ".||||||||||||||||||||||.",
        ".|H  à RR|ç {| ?A0|@C@|.",
        ".|H hs   ^   *    /   |.",
        ".|s   § 0|   |CCCg|@C@|.",
        ".||||||||||  ||||||||||.",
        ".|0 hr|  µ|  0|@  0ç @|.",
        ".|E hr|   + ~ |!     !|.",
        ".|E   | < |§  +      @|.",
        ".||||^|||||   |@     !|.",
        ".|U +         |!     @|.",
        ".||||||||||   |!@ @! !|.",
        ".|h s§s s0|   |||||||||.",
        ".|s h h hW|   |}   0 X|.",
        ".|h       +   +      §|.",
        ".||CCCZCCC|   |sHHHsRR|.",
        ".|0      Y|   |||||||||.",
        ".|S1OCCFCC|{      +  S|.",
        ".|||||||||||*|||+||0 S|.",
        ".|qqqqqqG§    |   |   |.",
        ".|          h |+|+|+|+|.",
        ".|LLLLLLG  CàC|9|9|t|t|.",
        ".||||||||||||||||||||||.",
        "........................"
      ],
      "palettes": [ "domestic_general_and_variant_palette", "standard_domestic_basement_palette" ],
      "terrain": {
        "{": "t_card_military",
        ".": "t_soil",
        " ": "t_floor",
        "|": "t_wall_metal",
        "*": "t_door_metal_locked",
        "^": "t_door_locked_interior",
        "/": "t_door_curtain_c",
        "µ": "t_card_reader_broken"
      },
      "furniture": {
        "F": "f_heavy_duty_fridge",
        "@": "f_bunkbed",
        "Z": "f_counter_gate_c",
        "L": "f_locker",
        "E": "f_locker",
        "G": "f_locker",
        "g": "f_glass_fridge",
        "}": "f_pinball_machine",
        "0": "f_air_conditioner",
        "ç": "f_speaker_cabinet",
        "à": "f_console_broken",
        "A": "f_autodoc",
        "?": "f_autodoc_couch"
      },
      "items": {
        "R": { "item": "bunker_basement_books", "chance": 70 },
        "Y": { "item": "SUS_trash_trashcan", "chance": 50 },
        "!": { "item": "bunker_basement_clothing", "chance": 50 },
        "s": { "item": "dining", "chance": 45 },
        "q": [
          { "item": "milspec_arsenal_group_only_guns", "chance": 100 },
          { "item": "arsenal_mics_group", "chance": 70 },
          { "item": "c4_box_part", "chance": 10 },
          { "item": "grenade_can_pa120_grenades_full", "chance": 10 }
        ],
        "U": { "item": "SUS_janitors_closet", "chance": 100 },
        "L": { "item": "milspec_arsenal_group_only_ammo", "chance": 100, "repeat": [ 2, 4 ] },
        "G": { "item": "arsenal_armor_collection", "chance": 100 },
        "E": { "item": "guns_rifle_milspec", "chance": 100 }
      },
      "place_fields": [ { "field": "fd_blood", "x": 2, "y": 3 }, { "field": "fd_blood", "x": 3, "y": 3 } ],
      "place_loot": [
        { "group": "energy_weapon_armory", "x": [ 2, 6 ], "y": 19, "chance": 60, "repeat": [ 0, 2 ] },
        { "group": "hospital_medical_items", "x": [ 14, 16 ], "y": 4, "chance": 70, "repeat": [ 1, 3 ] },
        { "group": "bunker_basement_drugs", "x": [ 14, 16 ], "y": 4, "chance": 80, "repeat": [ 1, 3 ] },
        { "group": "dining", "x": [ 8, 9 ], "y": 17, "chance": 75, "repeat": [ 1, 2 ] },
        { "group": "SUS_oven", "x": 4, "y": 17, "chance": 70 },
        { "group": "cleaning", "x": 2, "y": 10, "chance": 70 },
        { "group": "bunker_basement_suicide", "x": 3, "y": 3 },
        { "item": "mess_tray", "x": [ 5, 6 ], "y": 17, "chance": 50, "repeat": [ 4, 5 ] },
        { "item": "whiskey", "x": 5, "y": 3 },
        { "item": "glass", "x": 5, "y": 3 },
        { "item": "militarymap", "x": 5, "y": 3 },
        { "group": "bionics", "x": 15, "y": 4, "chance": 50 },
        { "group": "bionics_mil", "x": 16, "y": 4, "chance": 65 },
        { "item": "anesthetic_kit", "x": 17, "y": 4, "ammo": 100 },
        { "item": "television", "x": 17, "y": 13, "chance": 95 },
        { "item": "stereo", "x": 19, "y": 15, "chance": 80 }
      ],
      "vehicles": { "n": { "vehicle": "hospital_bed", "status": 0 } },
      "monster": { "~": { "monster": "mon_turret_rifle" } },
      "nested": { "§": { "chunks": [ "fire_extinguisher" ] } }
    }
  },
  {
    "type": "mapgen",
    "om_terrain": [ "bunker_basement_1" ],
    "weight": 200,
    "object": {
      "fill_ter": "t_floor",
      "rows": [
        "........................",
        ".||||||||||||||||||||||.",
        ".|H  à RR|3 {| ?A2|bCb|.",
        ".|H cY   ^   *    /   |.",
        ".|s     2|   |CCCg|bCb|.",
        ".|||||||||   ||||||||||.",
        ".|H |r2dd|   2|b  23 b|.",
        ".|H |r c +  ~ |!     !|.",
        ".|s +   <|    +      b|.",
        ".||||||||||   |b     !|.",
        ".|c s s s2|   |!     b|.",
        ".|s c c cW|   |!b b! !|.",
        ".|c       +   |||||||||.",
        ".||||+|||||   |}   2 X|.",
        ".|2      T|   +       |.",
        ".|S1OCCFCC|   |sHHHsRR|.",
        ".|||||||||| ~ |||||||||.",
        ".|L +             +  S|.",
        ".|||||^|||||+|||+||2 S|.",
        ".|rrrrrrr|   µ|   |   |.",
        ".|       *    |+|+|+|+|.",
        ".|LLLLLLL|{   |9|9|t|t|.",
        ".||||||||||||||||||||||.",
        "........................"
      ],
      "palettes": [ "domestic_general_and_variant_palette", "standard_domestic_basement_palette" ],
      "terrain": {
        "{": "t_card_military",
        ".": "t_soil",
        " ": "t_floor",
        "|": "t_wall_metal",
        "*": "t_door_metal_locked",
        "^": "t_door_locked_interior",
        "/": "t_door_curtain_c",
        "µ": "t_card_reader_broken"
      },
      "furniture": {
        "r": "f_rack",
        "F": "f_heavy_duty_fridge",
        "d": "f_desk",
        "c": "f_chair",
        "b": "f_bunkbed",
        "T": "f_trashcan",
        "L": "f_locker",
        "A": "f_autodoc",
        "Y": "f_table",
        "?": "f_autodoc_couch",
        "g": "f_glass_fridge",
        "}": "f_pinball_machine",
        "2": "f_air_conditioner",
        "3": "f_speaker_cabinet",
        "à": "f_console_broken"
      },
      "items": {
        "s": { "item": "dining", "chance": 45 },
        "b": { "item": "bed", "chance": 60 },
        "R": { "item": "bunker_basement_books", "chance": 80 },
        "T": { "item": "SUS_trash_floor_light", "chance": 50 },
        "!": { "item": "bunker_basement_clothing", "chance": 50 },
        "L": { "item": "milspec_arsenal_group_only_ammo", "chance": 100, "repeat": [ 1, 2 ] }
      },
      "place_loot": [
        { "group": "surgery", "x": [ 14, 16 ], "y": 4, "chance": 70, "repeat": [ 1, 3 ] },
        { "group": "bunker_basement_drugs", "x": [ 14, 16 ], "y": 4, "chance": 80, "repeat": [ 1, 3 ] },
        { "group": "mags_milspec", "x": [ 2, 6 ], "y": 21, "chance": 100, "repeat": [ 2, 6 ] },
        { "group": "ammo_milspec", "x": [ 2, 6 ], "y": 21, "chance": 100, "repeat": [ 30, 150 ] },
        { "group": "grenades", "x": [ 2, 6 ], "y": 21, "chance": 100, "repeat": [ 10, 30 ] },
        { "group": "mil_armor", "x": [ 7, 8 ], "y": 19, "chance": 65, "repeat": [ 1, 2 ] },
        { "group": "energy_weapon_armory", "x": [ 2, 8 ], "y": 19, "chance": 60, "repeat": [ 1, 3 ] },
        { "group": "guns_rifle_milspec", "x": [ 2, 6 ], "y": 19, "chance": 80, "repeat": [ 1, 2 ] },
        { "group": "guns_launcher_milspec", "x": [ 2, 6 ], "y": 19, "chance": 90, "repeat": [ 1, 2 ] },
        { "group": "gear_soldier_sidearm", "x": [ 2, 6 ], "y": 19, "chance": 90, "repeat": [ 1, 2 ] },
        { "group": "guns_rifle_milspec", "x": 5, "y": [ 6, 7 ], "chance": 80, "repeat": [ 1, 2 ] },
        { "group": "SUS_fridge", "x": 7, "y": 15, "chance": 70, "repeat": 3 },
        { "group": "bunker_basement_food", "x": [ 5, 6 ], "y": 15, "chance": 75, "repeat": [ 1, 2 ] },
        { "group": "dining", "x": [ 8, 9 ], "y": 15, "chance": 75, "repeat": [ 1, 2 ] },
        { "group": "SUS_oven", "x": 4, "y": 15, "chance": 70 },
        { "group": "cleaning", "x": 2, "y": 17, "chance": 70 },
        { "group": "bionics", "x": 15, "y": 4, "chance": 35 },
        { "group": "bionics_mil", "x": 16, "y": 4, "chance": 75, "repeat": [ 1, 2 ] },
        { "group": "alcohol", "x": 5, "y": 3 },
        { "item": "plasma", "x": [ 7, 8 ], "y": 19, "chance": 50, "repeat": [ 0, 2 ] },
        { "item": "glass", "x": 5, "y": 3 },
        { "item": "militarymap", "x": 5, "y": 3, "chance": 80 },
        { "item": "anesthetic_kit", "x": 17, "y": 4, "ammo": 100 },
        { "item": "television", "x": 17, "y": 13, "chance": 95 },
        { "item": "stereo", "x": 19, "y": 15, "chance": 80 }
      ],
      "monster": { "~": { "monster": "mon_turret_rifle" } }
    }
  }
]