[
  {
    "type": "mapgen",
    "om_terrain": [ "cave_underground" ],
    "weight": 350,
    "object": {
      "fill_ter": "t_dirt_underground",
      "rotation": [ 0, 3 ],
      "rows": [
        "........................",
        ".......11111111111......",
        ".....111        1111....",
        ".....111    2    111....",
        "....111     2    111....",
        "...11       2      11...",
        "...11       2      11...",
        "...11       2      11...",
        "...11       2      11...",
        "...11       2      11...",
        "...11111    2    1111...",
        "......11    2    1......",
        "........    2    .......",
        "........    2    .......",
        "........    2    .......",
        "........    2    .......",
        "..........  2  .........",
        "........... 2 ..........",
        "........... 2 ..........",
        "........... 2 ..........",
        "........... 2 ..........",
        "........... 2 ..........",
        "........... 2 ..........",
        "............>..........."
      ],
      "terrain": { ".": "t_soil", " ": "t_dirt_underground", ">": "t_slope_up", "2": "t_railroad_track_small" },
      "furniture": {  },
      "item": { "1": { "item": "broken_fcl_molebot", "chance": 2 } },
      "items": { "1": { "item": "cave_minerals", "chance": 40, "repeat": [ 1, 3 ] } },
      "monsters": { " ": { "monster": "GROUP_CAVE", "chance": 2 } }
    }
  }
]
